000000000000000000000000000000000000000000000
000000000000000000000000000000000000000000000
000000000000000000000000000000000000000000000
000000000000000000000000000000000000000000000
000000000000000000000000000000000000000000000
000000000000000000000000000000000000000000000
220000000000000002222200000000000002222222222
112222222222222221111122200000000021111111111
111111111111111111111111100000000011111111111
111111111111111111111111100000000001111111111
111111111111111111111111100000000000001111111
111111111111111111111111100000000000000011111
111111111111111111111111100000000000000000000
